W W W G G G G G T G G G G G G G G G G G G G G G G G G G G G G G T G G G G G G G W W G G T G G G G G
W W W W G G T G G G G G T T G G G G G G G G G G G G G G T G G G G G G G G G G G G W W G G G G G G G
W W W W W G G G G G G G G T G G G G G G G G T G G G G G G G G G G G G G G G G G G G G W G G G G G G
G G W W W W G G G G G G G G G G G G G G G G G G G G G G G G G G G G G G G G G G G G G G W G T G G G
G G W W W W G G G G G G G G G G G G G G G G G G G G G G G G G G G G T G G G G G G G G G W W G G G G
G G G W W W W G G G G G T G G G G G G G G G G G G G G G G G G G G G G G G G G G G G G G G W G G G G
G G G G W W W W W G G G G G G G G G G G G G T G G G G G T G G G G G G G G G G G G G G G G W G G G G
G G G G G W W W W W W G G G W W W W W G G G G G G G G G G G G T G G G G G G G G G G G G G G W G G G
G G G T G G G W W W W W W W W W W W W W W G G G G G G G G G G G G G G G G G G G G G G G G G W G G G
G G G G G G G G G W W W W W W W W G W W W W G G G T G G G G G G G G G G G T G G G G G G G W W G G G
G G T G G G G G G G G G W W G G G G G G W W W G G G G G G T G G G G G G G G G G G G G G G W T W G G
G G G G G G T G G G G G G G G T G G G G G W W W W G G G G G G G G G G G T G G G G G G G W G G W G G
G G G G G G G G G G G G G G G G G G G T G G G W W W G G G G G G G G G G G G G G G G G G W T G W G G
G G G G G G G G G G G G G G G G G G G G G G G W W W G G G G G G G T G G G G G T G G G W G G G W G G
G G G G G G G G G G G G G G G G G G G G G G G G W W W G G G T G G G G G G G G G G G G G G G W G G G
G G G G G G G G G T G G G G G G G G G T G G G G G W W W G G G G G G G G G G G G G G G G G G W G G G
G G G G G G G G G G G G G G G G T G G G G G G G G G W W W G G G G G G G T G G G G G G G G W G G G G
G G G G G G G G G G G G G G G G G G G G G G G T G G W W W G G G T G G G G G G G G G G G G W G G G G
G G G G G G G G G G G G G G G G G G G G G G G G G G G W W W G G G G G G G G G G G G G G G W G G G G
G G G G G G G G G G G G G G G G G G G G G G G G G G G W W W G G G G G G G G G G G G G G W G G G G G
G G G G G G G G G G G G G G G G G G G G G G G T G G G W W W W G G G G G G G G G G G G G W G G G G T
G G G G G G G G G G G G G G G G G G G G G G G G G G G G W W W G G G G G G G G G G G G W G G G G G G
G G G G G G G G G G G G G G G G G G G G G G G G G G T G G W W W G G G T G G G G G G G G G G G G G G
G G G G G G G G G G G G G G G G G G G G G T G G G G G G G W W W G G G G G G G G G G G G G G G G G G
G G T G G G G G G G G G G G G G G G G G G G G G G T G G G G W W G G G G G G G G G G G G G G G G T G
G G G G G G G G G G G G G G G G G G G G G G G G G G G G G G W W W G T G G G G G G G G G G G G G G G
G G G G G G G G G G G G G G G G G G G G G G G G G G G G T G G W W W G G G G G T G G G G G G G G G G
G G G G G G G G G G G G G G G G G G G G G G G G G G G G G G G G W W G G G G G G G G G G G G G G G G
G G G G G G G G G G G G G G G G G G G G G G G T G G G G G G W W W W G G T G G G G G G G G G G G G G
G G G G G G G G G G G G G G G G G G G G G G G G G G G G T G W W W G G G G G G G G G G G G G G G G G
G G G G G G G G T G G G G G G G G G G G G G G G G T G G G G W W G G T G G G G G G G G G G G G G G G
G G G G G G G G G G G G G G G G G G G G G G G G G G G G G W W W G G G G G G T G G G G G G G G G G G
G G G G G G G G G G G G G G G G G G G G G G T G G G G G W W W G G G G T G G G G G G G G G T G G G G
G G G G G G G G G G G G G G G G G G G G G G G G G G G G W W W G T G G G G G G G G G G G G G G G G G
G G G G G G G G G G G G G G G G G G G G G G G G G G G W W W G G G G G G G G G G G G G G G G G G G G
T G G G G G G G G G G G G G G G G G G G G G G G G G G W W G G G T G G G G G G G G G G G G G G G G G
G G G G G G G G G G G G G G G G G G G G G G G T G G W W W G G G G G G G T G G G G G G G G G G G G G
G G G G G G G G G G G G G G G G G G G G G G G G G G W W G G G G G T G G G G G G G G G G G G G G G G
G G G G G G G G G G G G G G G G G G G G G G G G G G G W G G G G G G G G G G G G G G G G G G G G G G
G G G G G G G G G G G G G G G G G G G G G G G G G T G W G T G T G G G G G G G G G G G G G G G G G G
G G G G G G G G G G G G G G G G G G G G G G G G G G W W G G G G G G G G G G G G G G G G G G G T G G
G G G G G G G G G G G G G G G G G G G G G T G G G W W G G G G G G G G G G G G G G G G G G G G G G G
G G G T G G G G G G G G G G G G G G G G G G G G G W G G G G G G G T G G G G G G G G G G G G G G G G
G G G G G G G G G G G G G G G G G G G G G G G G G W G G G G G G G G G G G G G G G G G G G G G G G G
G G G G G G G G G G G G G G G G G G G T G G G G G W G G G G G G G G G G G G G G G G G G G G G G G G
G G G G G G G G G T G G G G G G G G G G G G G G G G G G G G G G G G G G G G G G G G G G G G G G G G
G G G G G G G G G G G G G G G G G G G G G G G G G G G G G T G G G G G G G G G G G G G G G G G G G G
G G G G G G G G G G G G G G G G G G G G G G G G G G G G G G G G G G G G G G G G G G T G G G G G G G
G T G G G G G G G G G G G G G G G G G T G G G G G G G G G G G G G G G G G G G G G G G G G G G G G G
G G G G G G G G G G G G G G G G G G G G G G G G G G G G G G G G G G G G G G G G G G G G G G G G G G